"","Var1","0","1","sum","no_of_zero"
"1","INDIGO_true_false",16,31,47,34
"2","INDOCO_true_false",91,86,177,51.4
"3","INDUSINDBK_true_false",66,141,207,31.9
"4","INDUSTOWER_true_false",50,32,82,61
"5","INFY_true_false",84,153,237,35.4
"6","INGERRAND_true_false",102,105,207,49.3
"7","INOXLEISUR_true_false",76,88,164,46.3
"8","IOB_true_false",125,82,207,60.4
"9","IOC_true_false",112,125,237,47.3
"10","IOLCP_true_false",39,68,107,36.4
"11","IPCALAB_true_false",67,170,237,28.3
"12","IRB_true_false",85,55,140,60.7
"13","IRCON_true_false",2,11,13,15.4
"14","IRCTC_true_false",0,0,0,NA
"15","ISEC_true_false",3,15,18,16.7
"16","ITC_true_false",85,152,237,35.9
"17","ITI_true_false",117,90,207,56.5
"18","J&KBANK_true_false",88,118,206,42.7
"19","JAGRAN_true_false",97,67,164,59.1
"20","JAICORPLTD_true_false",106,101,207,51.2
"21","JAMNAAUTO_true_false",45,61,106,42.5
"22","JBCHEPHARM_true_false",70,137,207,33.8
"23","JCHAC_true_false",67,140,207,32.4
"24","JINDALSAW_true_false",107,100,207,51.7
"25","JINDALSTEL_true_false",104,133,237,43.9
"26","JKCEMENT_true_false",60,103,163,36.8
"27","JKLAKSHMI_true_false",81,79,160,50.6
"28","JKPAPER_true_false",89,83,172,51.7
"29","JKTYRE_true_false",79,105,184,42.9
"30","JMFINANCIL_true_false",82,74,156,52.6
"31","JSL_true_false",112,79,191,58.6
"32","JSLHISAR_true_false",26,19,45,57.8
"33","JSWENERGY_true_false",76,41,117,65
"34","JSWSTEEL_true_false",82,115,197,41.6
"35","JTEKTINDIA_true_false",87,102,189,46
"36","JUBLFOOD_true_false",35,81,116,30.2
"37","JUSTDIAL_true_false",48,28,76,63.2
"38","JYOTHYLAB_true_false",48,94,142,33.8
"39","KAJARIACER_true_false",48,159,207,23.2
"40","KALPATPOWR_true_false",83,124,207,40.1
"41","KANSAINER_true_false",50,157,207,24.2
"42","KARURVYSYA_true_false",85,152,237,35.9
"43","KEC_true_false",75,131,206,36.4
"44","KEI_true_false",70,93,163,42.9
"45","KNRCON_true_false",55,85,140,39.3
"46","KOLTEPATIL_true_false",75,67,142,52.8
"47","KOTAKBANK_true_false",26,193,219,11.9
"48","KRBL_true_false",80,133,213,37.6
"49","KSB_true_false",81,126,207,39.1
"50","KSCL_true_false",42,102,144,29.2
"51","KTKBANK_true_false",109,124,233,46.8
"52","L&TFH_true_false",54,44,98,55.1
"53","LALPATHLAB_true_false",13,33,46,28.3
"54","LAOPALA_true_false",49,102,151,32.5
"55","LAURUSLABS_true_false",19,15,34,55.9
"56","LAXMIMACH_true_false",72,135,207,34.8
"57","LEMONTREE_true_false",18,0,18,100
"58","LICHSGFIN_true_false",78,129,207,37.7
"59","LINDEINDIA_true_false",69,164,233,29.6
"60","LT_true_false",69,138,207,33.3
"61","LTI_true_false",6,33,39,15.4
"62","LTTS_true_false",12,25,37,32.4
"63","LUPIN_true_false",58,159,217,26.7
"64","LUXIND_true_false",19,27,46,41.3
"65","M&M_true_false",75,162,237,31.6
"66","M&MFIN_true_false",69,94,163,42.3
"67","MAHABANK_true_false",122,64,186,65.6
"68","MAHINDCIE_true_false",81,65,146,55.5
"69","MAHLOG_true_false",17,6,23,73.9
"70","MAHSCOOTER_true_false",58,149,207,28
"71","MAHSEAMLES_true_false",102,105,207,49.3
"72","MANAPPURAM_true_false",47,65,112,42
"73","MARICO_true_false",22,215,237,9.3
"74","MARUTI_true_false",67,128,195,34.4
"75","MASFIN_true_false",6,18,24,25
"76","IIFLWAM_true_false",0,1,1,0
"77","INDHOTEL_true_false",88,119,207,42.5
"78","INDIACEM_true_false",123,114,237,51.9
"79","INDIAMART_true_false",0,3,3,0
"80","INDIANB_true_false",85,66,151,56.3
"81","DBL_true_false",0,0,0,NA
"82","DCAL_true_false",0,0,0,NA
"83","DCBBANK_true_false",0,0,0,NA
"84","DCMSHRIRAM_true_false",0,0,0,NA
"85","DEEPAKNTR_true_false",0,0,0,NA
"86","DELTACORP_true_false",0,0,0,NA
"87","DHANUKA_true_false",0,0,0,NA
"88","DISHTV_true_false",0,0,0,NA
"89","DIVISLAB_true_false",0,0,0,NA
"90","DIXON_true_false",0,0,0,NA
"91","DLF_true_false",0,0,0,NA
"92","DMART_true_false",0,0,0,NA
"93","DRREDDY_true_false",0,0,0,NA
"94","ECLERX_true_false",0,0,0,NA
"95","EDELWEISS_true_false",0,0,0,NA
"96","EICHERMOT_true_false",0,0,0,NA
"97","EIDPARRY_true_false",0,0,0,NA
"98","EIHOTEL_true_false",0,0,0,NA
"99","ELGIEQUIP_true_false",0,0,0,NA
"100","EMAMILTD_true_false",0,0,0,NA
"101","ENDURANCE_true_false",0,0,0,NA
"102","ENGINERSIN_true_false",0,0,0,NA
"103","EQUITAS_true_false",0,0,0,NA
"104","ERIS_true_false",0,0,0,NA
"105","ESABINDIA_true_false",0,0,0,NA
"106","ESCORTS_true_false",0,0,0,NA
"107","EXIDEIND_true_false",0,0,0,NA
"108","FCONSUMER_true_false",0,0,0,NA
"109","FDC_true_false",0,0,0,NA
"110","FEDERALBNK_true_false",0,0,0,NA
"111","FINCABLES_true_false",0,0,0,NA
"112","FINEORG_true_false",0,0,0,NA
"113","FINPIPE_true_false",0,0,0,NA
"114","FLUOROCHEM_true_false",0,0,0,NA
"115","FORTIS_true_false",0,0,0,NA
"116","FRETAIL_true_false",0,0,0,NA
"117","FSL_true_false",0,0,0,NA
"118","GAEL_true_false",0,0,0,NA
"119","GAIL_true_false",0,0,0,NA
"120","GALAXYSURF_true_false",0,0,0,NA
"121","GARFIBRES_true_false",0,0,0,NA
"122","GEPIL_true_false",0,0,0,NA
"123","GESHIP_true_false",0,0,0,NA
"124","GHCL_true_false",0,0,0,NA
"125","GICRE_true_false",0,0,0,NA
"126","GILLETTE_true_false",0,0,0,NA
"127","GLAXO_true_false",0,0,0,NA
"128","GLENMARK_true_false",0,0,0,NA
"129","GMDCLTD_true_false",0,0,0,NA
"130","GMMPFAUDLR_true_false",0,0,0,NA
"131","GMRINFRA_true_false",0,0,0,NA
"132","GNFC_true_false",0,0,0,NA
"133","GODFRYPHLP_true_false",0,0,0,NA
"134","GODREJAGRO_true_false",0,0,0,NA
"135","GODREJCP_true_false",0,0,0,NA
"136","GODREJIND_true_false",0,0,0,NA
"137","GODREJPROP_true_false",0,0,0,NA
"138","GPPL_true_false",0,0,0,NA
"139","GRANULES_true_false",0,0,0,NA
"140","GRAPHITE_true_false",0,0,0,NA
"141","GRASIM_true_false",0,0,0,NA
"142","GREAVESCOT_true_false",0,0,0,NA
"143","GRINDWELL_true_false",0,0,0,NA
"144","GRSE_true_false",0,0,0,NA
"145","GSFC_true_false",0,0,0,NA
"146","GSPL_true_false",0,0,0,NA
"147","GUJALKALI_true_false",0,0,0,NA
"148","GUJGASLTD_true_false",0,0,0,NA
"149","GULFOILLUB_true_false",0,0,0,NA
"150","HAL_true_false",0,0,0,NA
"151","HATHWAY_true_false",0,0,0,NA
"152","HATSUN_true_false",0,0,0,NA
"153","HAVELLS_true_false",0,0,0,NA
"154","HCLTECH_true_false",0,0,0,NA
"155","HDFC_true_false",0,0,0,NA
"156","HDFCAMC_true_false",0,0,0,NA
"157","HDFCBANK_true_false",0,0,0,NA
"158","HDFCLIFE_true_false",0,0,0,NA
"159","HEG_true_false",0,0,0,NA
"160","HEIDELBERG_true_false",0,0,0,NA
"161","HERITGFOOD_true_false",0,0,0,NA
"162","HEROMOTOCO_true_false",0,0,0,NA
"163","HFCL_true_false",0,0,0,NA
"164","HINDALCO_true_false",0,0,0,NA
"165","HINDCOPPER_true_false",0,0,0,NA
"166","HINDPETRO_true_false",132,105,237,55.7
"167","HINDUNILVR_true_false",73,164,237,30.8
"168","HINDZINC_true_false",100,106,206,48.5
"169","HONAUT_true_false",46,161,207,22.2
"170","HSCL_true_false",87,64,151,57.6
"171","HUDCO_true_false",23,6,29,79.3
"172","IBREALEST_true_false",111,70,181,61.3
"173","IBULHSGFIN_true_false",34,41,75,45.3
"174","ICICIBANK_true_false",59,148,207,28.5
"175","ICICIGI_true_false",2,23,25,8
"176","ICICIPRULI_true_false",16,21,37,43.2
"177","ICRA_true_false",72,78,150,48
"178","IDBI_true_false",125,88,213,58.7
"179","IDEA_true_false",90,61,151,59.6
"180","IDFC_true_false",92,78,170,54.1
"181","IDFCFIRSTB_true_false",37,10,47,78.7
"182","IEX_true_false",10,14,24,41.7
"183","IFBIND_true_false",83,124,207,40.1
"184","IGL_true_false",55,135,190,28.9
"185","IIFL_true_false",81,92,173,46.8
"186","CUMMINSIND_true_false",82,125,207,39.6
"187","CYIENT_true_false",73,86,159,45.9
"188","DABUR_true_false",31,176,207,15
"189","DALBHARAT_true_false",4,6,10,40
"190","DBCORP_true_false",70,47,117,59.8
